0,0,0,0,0,0,1,0,0,1,0,0,0,0,0,0
0,1,1,1,0,1,1,0,0,1,1,0,1,1,1,0
0,1,0,0,0,0,0,0,0,0,0,0,0,0,1,0
0,1,0,0,0,1,1,0,0,1,1,0,0,0,1,0
0,0,0,0,0,1,0,0,0,0,1,0,0,0,0,0
1,1,1,1,0,0,0,0,0,0,0,0,1,1,1,1
1,1,1,1,0,0,0,0,0,0,0,0,1,1,1,1
0,0,0,0,0,1,0,0,0,0,1,0,0,0,0,0
0,1,0,0,0,1,1,0,0,1,1,0,0,0,1,0
0,1,0,0,0,0,0,0,0,0,0,0,0,0,1,0
0,1,1,1,0,1,1,0,0,1,1,0,1,1,1,0
0,0,0,0,0,0,1,0,0,1,0,0,0,0,0,0
2,,,,,,,,,,,,,,,
8,11,Player,,,,,,,,,,,,,
8,0,Doctor,,,,,,,,,,,,,
