0,0,0,0,0,0,0,1,1,0,0,0,0,0,0,0
0,1,1,1,1,1,0,1,1,0,1,1,1,1,1,0
0,1,0,0,0,0,0,1,1,0,0,0,0,0,1,0
0,1,0,0,0,0,0,0,0,0,0,0,0,0,1,0
0,0,0,0,0,0,0,0,0,0,0,0,0,0,0,0
1,1,1,0,0,0,0,0,0,0,0,0,0,1,1,1
1,1,1,0,0,0,0,0,0,0,0,0,0,1,1,1
0,0,0,0,0,0,0,0,0,0,0,0,0,0,0,0
0,1,0,0,0,0,0,0,0,0,0,0,0,0,1,0
0,1,0,0,0,0,0,1,1,0,0,0,0,0,1,0
0,1,1,1,1,1,0,1,1,0,1,1,1,1,1,0
0,0,0,0,0,0,0,1,1,0,0,0,0,0,0,0
2,,,,,,,,,,,,,,,
11,5,Player,,,,,,,,,,,,,
4,6,Doctor,,,,,,,,,,,,,
